111111111111111111111
101000000001010000001
100000C00000011000001
1000000010C001E100001
10110000P000001000001
10111100000000C000001
111111111111111111111