1111111111111111111111
1010C0010001E000010001
1010000000011100010001
10111100P0001000110001
1000C0000000C000000001
1111111111111111111111

