11111111111111111111
100000C0000000000001
1000000P00C00000C001
1000000E001111100001
11111111111111111111