1111111111111111111
1010000000010100011
1000000000000000001
1000000000C000E0001
10111100P0000000001
1111111111111111111
