1111111111111111111111
1000C0110000E000000001
1000000000111100000001
1000000P00000000000001
1000C0000000C000000001
1111111111111111111111

