1111111111111111111
10100CCCCC010100011
10000CCCCC000000001
10000C1000C000E0001
1010001100000000001
10100100000P000C001
1111111111111111111