1111111111111111111
1010000000010100011
100000C000000000001
1000001000C000E0001
1010001100000000001
10100100000P000C001
1111111111111111111