1111111111111111111
1010C0010001E0C0011
10100000000C0000001
10111100P0001000001
1111111111111111111

