1111111111
1CCCCCCCC1
1EPCCCCCC1
1111111111