1111111111111111111
1010000000010100011
100000C000000000001
1000001000C000E0001
10100011P0000000001
101001000000000C001
1111111111111111111
