11111111111111111111111111111111111111
100000000000000C0000000000000000000111
100000000000000C0000000000000000000111
100000000000000C0000000000000000000111
100000000000000C0000000000000000000111
100000000000000C0000000000000000000111
100000000000000C0000000000000000000111
100000000000000C0000000000000000000111
100000000000000C0000000000E00000000111
100000000000000C0000000000000000000111
100000000000000C0000000000000000000001
100000000000000C0000000000000000000001
100000000000000C0000000000000000000001
100000000000000C0000000000P00000000000
100000000000000C0000000000000000000001
100000000000000C0000000000000000000001
100000000000000C0000000000000000000001
100000000000000C0000000000000000000001
100000000000000C0000000000000000000001
100000000000000C0000000000000000000001
100000000000000C0000000000000000000001
100000000000000C0000000000000000000001
100000000000000C0000000000000000000001
100000000000000C0000000000000000000001
11111111111111111111111111111111111111
