11111111111111111111111111111111111111
100000000000000C00000C0000000000011111
10100101001000001010010000000101011111
10100100101010100010010000000101E11111
1P0000000C00C0000000000000000001111111
11111111111111111111111111111111111111
11111111111111111111111111111111111111
11111111111111111111111111111111111111
11111111111111111111111111111111111111
11111111111111111111111111111111111111
11111111111111111111111111111111111111
11111111111111111111111111111111111111
11111111111111111111111111111111111111
11111111111111111111111111111111111111
11111111111111111111111111111111111111
11111111111111111111111111111111111111
11111111111111111111111111111111111111
11111111111111111111111111111111111111
11111111111111111111111111111111111111
10111111111111111111111111111111111101
11111111111111111111111111111111111111